
NO ./textures/redbrick.xpm
EA ./textures/colorstone.xpm
SO ./textures/redbrick.xpm
WE ./textures/redbrick.xpm
F 147, 159,
C 219, 213, 213

                 1111
                 1001
                 1001
                 1001
11111    11111   1001
10001    1000111110011111111111
10001    1000000000000000000001
10001    1000000000000000000001
10001    1000111101111111100001
10001    10001  101      100001
10001    10001  101111111100001
10001111110001  100000000000001
10000000000001  111110111100001
10000000000001      10111100001
10000N00000001      10000000001
10000000000001      10000000001
10111111111111      11111111111
100000001           10000000001
1111110011111111111110000000001
1000000010001000000000000000011
100000000000000000000000000001
111111111111111111111111111111