
NO ./textures/redbrick.xpm
EA ./textures/colorstone.xpm
SO ./textures/redbrick.xpm
WE ./textures/redbrick.xpm
F 147, 159, 153
C 219, 213, 213

111111111
100000001
1
1000N0001
111111111
