

NO ./textures/redbrick.xpm
SO ./textures/colorstone.xpm
WE ./textures/greystone.xpm

EA ./textures/wood.xpm
F 110,100,0
C 120,30,90


                                     11111
                                     10001
       1111111111111111111111        11011         1111111111111111111111111
   11111000000000000000000001111111111101111111111110000000000000000000001111 111
11110000000000000S000000000000000000000000000000000000000000000000000000000011111
   11111000000000000000000001111111111000111111111110000000000000000000011111
       1111111111011111111111        11011         1111111111011111111111
                101                   101                   101
                101                   101                   101
                101                   101                   101
            11111011111               101               11111011111
            10000000001               101               10000000001
            11111011111               101               11111011111
                101                   101                   101
                101                   101                   101
                1011                  101                   101
                1001111111111111111111101111111111111111111110111111111111111111111111111111111111111111111111111111111111111111111111111111111111111111
                10000000000000000000111000000000000000000000000000000000000000000000000000000000000000000000000000000000000000000000000000000000100000011
                1111111111111111111111101111111111111111111111111111111111111111111111111111111111111111111111111111111111111111111111111111111111111111
                                      101
                                      101
                                      101
                                      101
                                    1110111
                                    1000001
                                    1110111
                                      101
                                      111