NO ./textures/greystone.xpm
EA ./textures/minecraft_textures/nether_bricks.xpm
SO ./textures/minecraft_textures/tnt_side.xpm
WE ./textures/wood.xpm
F 92,72,40
C 170,237,250


111111111111111111111111
101111111111100000000001
111000000000100000100001111
100000000000100000100001101
1111101111011000001000011011
1000000000001000001000010001
1000000000001111011110010001
1000100000001000000001010001
1000100000001000000101000001
10000S1000000000001000100111
10000000000010000100000111
111111101111111111000001
100000000000000000100011
11111111111111110110111
111000011111111101101
111011011111111101101
111011000000000001101
111011000000000001101
111011000000000001101
111011111111111111101
111000000000000000001
111111111111111111111