
NO ./textures/greystone.xpm
EA ./textures/minecraft_textures/nether_bricks.xpm
SO ./textures/minecraft_textures/tnt_side.xpm
WE ./textures/wood.xpm
C   10,10,10
F    160,160,160





 11111111111111
110000000000001
10000000000000111111111
1111100000000000000001
    111110000000000011111111
        1000000000011
        1000000000011    111111
        110000000000111111110011
        111111110000000000000011111111
               1111111100000000000000111111
             1110000000000000000000001
    111111111100000000000000111111111111111111
    1000000000000000000000001
    1000000000000000000000001
    1000000111111111111110011
    100000011           100011
    10000000111111111   100001
    10000000000000001111110001
    10011111111110000000000001
    1001        11111111111001
    1001                  1001
    1001                111001
    1001                100001    11111111111111111111
    1001                100001  111111111111111111111
    1011                100001111000000000000000000011111111111111111111111111111
    1001                101010101010101010101010101010101010101010101010101010101
    10011               100011111111111111111111111111111111111111111111111111111
    100011              11111
    1000011
    11100011
   1100000011
1111000000001
1000000000001
1000000000001
1000000000001
1000000N00001
1000000000001
1000000000001
1111110111111
1111110111111
1111110111111
1111110111111
1000000000001
1000000000001
1000000000001
1111111111111