NO ./textures/greystone.xpm
EA ./textures/test.png
SO ./textures/minecraft_textures/tnt_side.xpm
WE ./textures/wood.xpm
F 220,100,0
C 225,30,0


           111111111111111111
          1100000N000000000011
         11000000100000100001111
 11111111100000001100011100011111
11000000000000000000000000000111
111111100111111111111110001111
      10001           10001
      11111           11111